20
15
22 22 22 22 22 22 22 22 22 22 22 22 22 22 22 22 22 22 22 22
22 19 17 17 17 17 17 17 17 17 17 17 17 17 17 17 17 17 18 22
22 4 0 0 0 0 0 0 0 0 0 0 0 0 0 0 0 0 3 22
22 4 0 0 0 0 0 0 0 0 0 0 0 0 0 0 0 0 3 22
22 4 0 0 0 0 0 0 0 0 0 0 0 0 0 0 0 0 3 22
22 4 0 0 0 0 0 0 0 0 0 0 0 0 0 0 0 0 3 22
22 4 0 0 0 0 0 0 0 0 0 0 0 0 0 0 0 0 3 22
22 4 0 0 0 0 0 0 0 0 0 0 0 0 0 0 0 0 3 22
22 4 0 0 0 0 0 0 0 0 0 0 0 0 0 0 0 0 3 22
22 4 0 0 0 0 0 0 0 0 0 0 0 0 0 0 0 0 3 22
22 4 0 0 0 0 0 0 0 0 0 0 0 0 0 0 0 0 3 22
22 4 0 0 0 0 0 0 0 0 0 0 0 0 0 0 0 0 3 22
22 4 0 0 0 0 0 0 0 0 0 0 0 0 0 0 0 0 3 22
22 4 0 0 0 0 0 0 0 0 0 0 0 0 0 0 0 0 3 22
5 21 21 21 21 21 21 21 21 21 21 21 21 21 21 21 21 21 21 21
